10 15
#@ C#########%#
##C  #C# C    C
## ##C C  #C# #
C  C# C # ##  C
 ## C ##  #C # 
C##C # # # # ##
#C  # # # C# C 
CC#C #%#C #### 
C#&# # #  C## E
##%#C   C ###X#